##########
#E       #
#        #
#        #
#        #
#        #
#        #
#        #
#       S#
##########