####################################################################################################
#S     ####     #   ##       #        # ## #        #        ##  #            # #  #    #          #
######  ##  # #   #    # ###  # ##### #      # #### ###### #    ## ## ## #### #   #  # #  ## #### ##
#     #   ## # ### ##### #   #  #     # # #####   #       #  # #   #  # #   #  # #  #    #  #   #  #
## ##  ##                # #### ### #  ## #  #  # ##### # # #  # ##  #   ##  # # # #  ###  ## # # ##
#  # #   ###### ##### ###  # #     ###    ##   #       #  ## #     # # #   # # #   # #    #   # #  #
# ## # ##      #     #  # #   ####  # # ##  ##  ### # ## #    # ## # # ### # # # ### # ## # # # # ##
#    # #  ## ### ###   #  # #     # #  #   #   #   # #   # ##  # # # #   # # # ##    ## #    #  #  #
#### # # ###     #  ##  # #  # ## #  #   #   # # #   # ##    # #   #  # #  # #    ###    ####  #  ##
#   ## # ## #####  #  # # # #  #    #  # #### #  ### # #  ## #  #### ## # #  #####  # ##      # #  #
# #    #    #     ## #  # # # # ## #  #        #   # #  ###  ## #    #  #  #      #     # ###   # ##
# # ####### # ### #    #  # #     # ## ##### #  ## #   #   #  # # ##  # # ## ## # # # #  #   ## #  #
# ##   #  #  #    # ##  # ##  ### #         # #  #  ###  #  # #   ####  # #  ## # #  #  #  #  # # ##
#  # #  # # #  ###  # ##    # # # # ####### #   ### #   #  #  ###  #   #  # #   #  #  # # # #   #  #
## #  #   #  #    #     ### # # # # #     # ###  #  # #  # ##   ## # ## # # # ##  # ### # # ## # # #
#  # # # # #  ###  ####   # #   # # ## # ##    #   # ## #    ##   #   # # ##  # #        #    #    #
# #  # #   # #    #    ## # # # # #   ## # # # # # #     ###  ###  ## # #   # # ### # ## # ##   ####
#  # # # # # # ##  # #  #   #  #  ### #    ###  #  # ## #   #    #       ## # #    # # # #   ###   #
# ##   # # # #   #  ## # ## # #  #      # #   # # #    ## #  ### ######## # # # # #    # # # #   # #
#   ## # ### # # ##      # #   # # ###### # # # # ## # #  # #  #            # ##  # # #   #   # #  #
# # #  #     # #   # # #    # #  # #     #  # # #   #   # #  #  ### ### # ###   # # #   #  # #   # #
# #   # ### # # ##  # # ###  #  ## # ### # ## #  ##  ## # # # #    #   # #   ## # #  ### ###  # #  #
#  ###     #       #      # #  #   # # # # #    #  #  #   # # # ##   #     #    #   ##       #  # ##
# #    # #   ######  #####  ## # ##  #   # # ### #  #  # ## # #   ### # # #  # #  ##   ###### # #  #
#  ####   # #     ## #   # #   #  # #  ##   #      # # # #  #  ##     #  # ### ### # ##     #    # #
## #   #### # ###    # #   # ### ##  # # # #  ####   #  ## #  # #### # # #    #      #  ### # # #  #
#  # #      # #  # # #  ###        # # #   ###     # # #   ##      # # #   ##   ##### # # # # # # ##
# #  #######  ## # # ## # ## ######  # # ##   # ###  # # ##   # # #  #  ###  ###        #   # # # ##
# # #      # #   # #  # #    #      #  #    # # # # #  #  # ## #   #  #     #  # ### ###  ##  # #  #
#   # ## ##  # # #  # # # # #  #####  #  # ## # #   # #  #     # ##  #  # # ##     ##   # #  #   # #
# ### ##   # # # # ## # ## #  #     # ###  #  # # # #  # # ####   # # # ##    ####   # ##  #  # ## #
##      ##     # #   ##    # ## # # #    ##  #   #   # #  #     ### #     # ##    ## #   # # #  #  #
#  ##### # #####  ## # ### # #  # #  ### #  #  #  # #  ##  # # #    # ### #    ##    ## ## #  #  # #
# #       #     #  #     # #  # #  # # #  # # # # # # #   ##  #  ### #    # #### ## # # #   #  # ###
### # ###  # ##  #  # ####   #  ## # # # ## # # # ##  # #   # ## #    # ## #       #      ## # #   #
#   ##    ## # # # #  #   ## # # # # # #    # # #   # # # # #    ## # # #    ### #  # ####    ## # #
# ##   ###   # # ##  #  #   #  # # #    ####  #  ## # #  #  # ###   #   # # #   #  #  #    ## #  # #
# # ## # # ##  #   # # # # ## ## # ## #    # ## #   # # #  #  # # ## # #  ### # ##  # # ###   #### #
# #    #    ##   #   #   #       #   #  ####     # ##  #  # # #   #   ###     #   # # # #   ##     #
#  ###  # #   ##  #### #  # ####  ## # #    #### # #  #  #    ## ## #  ## ###  ## # #   # ###  ### #
##    # ### # #  #     ### #   ## ##  #  ##      # # # # # # #   #  # #      #  # #  ####     #  # #
#  ## #    #  ###  # ##      #   #   ## #  ######  # #    #  ### # # #  ####  ###  ##    ### #  #  #
### #  ###   #    # # # ##### # #  ##   ##      # ##  ###  #   # # # # #   ###    #   ##   ## #  # #
#     #    ##  # #    # #   # #  #  # ##   ## # #   # #   # ##   #   # # #     ## # ## # #    # ## #
# # ## # #  # # #  ## # # # #   #  #   # # ## #  # #  # ##    ##### ## # #### #   # #  #  # #   #  #
#  #    #  #  #   #   # # #  # # #  # #  #   #  #   #   #  ##    ##    #     #  ### # # # #  ###  ##
# #  ## ## # ### #  # #   # #  #   ##  ##  #  #  ##  ### ##   ###   ### ## #  ##    #   # # #    # #
# ##  #   #   #  # #   ####  # ###   # #  #  #  #   #  #   # #    ##      # #  # ###  # # # # ###  #
#    # ##  # #  # # ###    # #     # #  ####  ##  #   #  # # # ###  # # #   # #  #   # ## # # #   ##
# ###    #   # #        ## #  ### ##  #   #  #   ####   ## # #    # #  # ## #  #   # #    # # # #  #
# #  ###  # #    # ####   # # #  #   # ## # #  ## #  ###   #  ### #   #    #  # ## # # # #  # #  # #
#  #    #  # ## #  #   ##   #  # # ###  # # ##     # # # ####   #   # # ##  #    #  ## # # #    #  #
# # # #  #      #### #    #  # # # #   #  #   #### #   # # #  #  ## ##  # #   # ## #   ##   #### # #
#   #  # # # ###     ## # #### #   ## ## # ## #  #  # #  #   # # #   # #   ##  #   # ##   ##     # #
###   ##  #  # # #### #  #     # ##   #         #  #   # # # # #  # ##   # # ##  ##  #  ##   # # # #
#  #### #  #   # #  # ## # ####     ##  # # ###  #  # #  # # #   ##   ####     # # # # #   ### # # #
##      ## # # #  #      # #    #### # ### #  # ### # ##  #  ###   ## #   # ## # # # ##  ##    ##  #
# #### #   #  #  # # # ##  # ###        #   #    #  #   #  #    ### # # ## # # # # #   #  # ##  # ##
#      # #### # #   #   # # #    #######  #  # # # # # #  ## ##     # # #    #   #  ## # #   # #  ##
# #### # # #  # # #  ## # #   # #      # # #  #### #   # #     ####       ##  ## # # # #  ##  #  # #
# #    #    ##  #  #   ##  ##  #  # # #  #  #  #   # # # # # #    ## ###### ###  #   #  #   # ## # #
# ##### ###   # # # ##   #    #  ## # # # # ## # ##  # # ###  # #   #          #   #  # # # #    # #
#       # # # # # # #  ## ####  #   # # #    # # # # ###    #  # ## # ###### # # ## ##  #  # ## #  #
# #####    ## # #   # #      # #  ##  # # ##   # #      ### ###    #  #     ##  #     # ## #   # # #
#      ###    #   # # # # ## # ## # ###  ##  ###  # ###   #   # ##   #  ###   #   ### #  # # #     #
###### # ## #  # # #  #  ###    #      #   #    # #   # # ### # # ### #    ##  ###  #  # #  #  ### #
#      #   # ##    # # #  # # ### # ##  ## ## #   ## #  #   #   #   #   ###  #    # # ##  #  # # # #
## ## #  #      ####     #  ##   ## #  # #  ##  ##   # #  ## # ### #  ##    #  ##        #  #    # #
#  # #  # ## ###    # ###  #   # #   #   ##   ##  # #   #     # #   #  # # #  # ### ##### # # ###  #
##    #     #  # ## #   # ## ##   # #  #   ##   #   # ##  ###     #  # # #  ##     ##     # ##    ##
# ###  #### ## #  # # #   #  ### #   #  ## #  #  ## #   ##   ## ##  ## #  #    ### #  ### #  # ##  #
#     #        # #  #  #### # #  # ## # #   #  # #  # # #  # ###   #    #  ####  #   #  #  # #   # #
# #### # # # ###  # ###     # # # #   # # #  ###  #  #  # ##  #  # # # ## #     # #####  #   # ##  #
# #     ##  #    #      ##### # #   # # ### #    # #  #     #  # # # ##   # ###   #  #  # # #  #  ##
#   ###   ### ### ######      # ### # #    #  # ## # # ## ### #   ##  # ## #    # ##  # #  # # # # #
####   ## #   #          # ## #     # # ##  # ##   #   # #     ###   #  #    ####   #     #     ## #
#    # ##   ## # # # ###  # #  #####  #  # ##   # # ## # # ## #    ## # #### #   ## # # #   # #    #
# ###    # #   # ## #   # # # #     # # #    ## #      # # #  # # ##  #      ## # #  #   # # ## ## #
#   ##### # # ##    # # # # # # ### # #  # # #  # # ##   #  # #  #   # #### #   # ## # #  #     #  #
# #              # #  #   #   # # # #  ##  #  #  # ##  # # #   #   #       #  ##   # #### # ## #  ##
#  # # ###### ### #  # #### # #   #  #    # #  # #   ## #  #### ##  ### ## # #   # #   #  # # #  # #
# # # ##     #    # #      #   ## # # # ##   # #   #     #         #   #   #   ##   ##  ### #  #   #
# #      ##### ## # # #### ###  # #    #   # #  # # ## # ## # #####  # # ### ## # #### #    ##  # ##
# ## ## ##     #  #   #  #    # # # #### ### # # #    ##   # #      #  # #   #  #   #    ###   ##  #
#   #   #  #### #  ###  # ### ##  # #    #   # #   ##   ## #   ## ### #  # # # # ##  ####  # #    ##
### # ##  ##    ##    #     #    ##   # ## # # # #   ## #  # ### #    # # #        #      #  ### # #
# # # ## #   ##  # ####### ######  # # #   ##  # ## #    #   #   # # #     ## #### ##### ###    #  #
# # #    # ##  # #    #     #     # #   # #   #    #  ###  #### ##  #  ### # #   #     # ## ## #  ##
# #  ## #  # # #  ###   ###  # ## # # #   # ## ### # #   #   #  #  #  #        #  ## # #     # # # #
#  # #  # #    # #   # ##   #   #   #  #### #    # # # #  ## # #  # #  ###### # # #   #  # # # #   #
# #  ##   # ## # # # # #  ## # #  # # #       ##   # # # #     ## #   #      #  #  # #  ## # #  # ##
#   #  ## # ##     # #  # #    #### # # #### ## #### # #  ####  # # ##  # ##  #  #  #  ##  # # ##  #
# ## #  ##    # ### ## #  ### #    #  # #   #       #  ##     ##  #   # # # # # ###  ##   ## #    ##
# #   #    ###  #      ##   # # ## ## #   # # #####  #   ## #    # ## #  #  # #  # # #  ##    ###  #
# # #   # #   ### # ###  ## # # #     ##### #      #  ## #  ######     # # ##  #     # ##  ## #   ##
# # ####  # # #   ##   #  # # # # ####      ######  # ## # #      ## # # #   #  # ###  #  # #  # #E#
# #     ##  #   ##   #  # # # #  #   # ### #     # #     # # ## # #  ### # # # #      #  #   ### # #
# ######   # # #  # #  #      # ## #      # ### #  ###### ##   #  ###      # # ####### ##  #     # #
#        ##     #    #   # ## #     # # #        #           #  #     # # #  #            #  # #   #
####################################################################################################